#######################################
# Syntax Coloring Map for AceSegment library
#######################################

#######################################
# Datatypes (KEYWORD1)
#######################################

Hardware	KEYWORD1
HwSpiAdapter	KEYWORD1
SwSpiAdapter	KEYWORD1
SwSpiAdapterFast	KEYWORD1
LedMatrixBase	KEYWORD1
LedMatrixDirect	KEYWORD1
LedMatrixDirectFast	KEYWORD1
LedMatrixSingleShiftRegister	KEYWORD1
LedMatrixDualShiftRegister	KEYWORD1
LedDisplay	KEYWORD1
SegmentDisplay	KEYWORD1
NumberWriter	KEYWORD1
ClockWriter	KEYWORD1
CharWriter	KEYWORD1
StringWriter	KEYWORD1
hexchar_t	KEYWORD1

#######################################
# Methods and Functions (KEYWORD2)
#######################################

# Hardware.h
digitalWrite	KEYWORD2
pinMode	KEYWORD2
micros	KEYWORD2
millis	KEYWORD2

# SwSpiAdapter.h, HwSpiAdapter.h
begin	KEYWORD2
end	KEYWORD2
transfer	KEYWORD2
transfer16	KEYWORD2

# LedMatrix.h
begin	KEYWORD2
end	KEYWORD2
draw	KEYWORD2
clear	KEYWORD2
enableGroup	KEYWORD2
disableGroup	KEYWORD2

# SegmentDisplay
begin	KEYWORD2
end	KEYWORD2
getNumDigits	KEYWORD2
getFramesPerSecond	KEYWORD2
getFieldsPerSecond	KEYWORD2
writePatternAt	KEYWORD2
writeDecimalPointAt	KEYWORD2
setBrightnessAt	KEYWORD2
setGlobalBrightness	KEYWORD2
clear	KEYWORD2
renderFieldNow	KEYWORD2
renderFieldWhenReady	KEYWORD2
prepareToSleep	KEYWORD2
wakeFromSleep	KEYWORD2

# NumberWriter.h
writeRawHexCharAt	KEYWORD2
writeHexCharAt	KEYWORD2
writeHexCharsAt	KEYWORD2
writeHexByteAt	KEYWORD2
writeHexWordAt	KEYWORD2
writeDecWordAt	KEYWORD2

# ClockWriter.h
writeDecimalAt	KEYWORD2
writeCharAt	KEYWORD2
writeColon	KEYWORD2
writeClock	KEYWORD2
writeBcdClock	KEYWORD2

# CharWriter.h
writeCharAt	KEYWORD2
getLedDisplay	KEYWORD2

# StringWriter.
writeStringAt	KEYWORD2
getLedDisplay	KEYWORD2

#######################################
# Instances (KEYWORD2)
#######################################

#######################################
# Constants (LITERAL1)
#######################################

# NumberWriter.h
kNumCharacters	LITERAL1
kSpace	LITERAL1
kPeriod	LITERAL1
kMinus	LITERAL1

# ClockWriter.h
kNumCharacters	LITERAL1
kSpace	LITERAL1
kMinus	LITERAL1
kA	LITERAL1
kP	LITERAL1
kDegrees	LITERAL1

# CharWriter.h
kNumCharacters	LITERAL1
